
 1
1011
 1N01
 1111111
100000001
1001111011
1100000001
11000000001
110001000001
100000000001
100000000001
100000000001
100000000001
100000000001
100000000001
10100000001
100000000101
100000000001
100000000001
100000000001
100000000001
100000000001
100000000001
100000000001
100001000001
100000000001
100000000101
100000000001
100000000001
100000000001
100000000001
100000000001
11111011101
     1   1





