NO ./textures/wolfenstein/blue_stone.xpm
EA ./textures/wolfenstein/color_stone.xpm
WE ./textures/wolfenstein/grey_stone.xpm
SO ./textures/wolfenstein/mossy.xpm

F 12,12,12
C 210,210,210

 111111111111111111111111111111111111111111111111111111
1N000000000000000000000000000000000000000000000000000001
10000000010000000000100000000100000000000000000000000001
10000000000000000000000000000000000000000000000000000001
10000000000000000000000000000000000010000000100000000001
10000010000000000000000100000000000000000000000000000001
10000011111110100000000000000000100000000001000000000001
10000001000000000000000000000000000000000011000000000001
10000000010101000000000100000000000000000000000000000001
10000001000000000000000000000011000000000000000000000001
10000000000010010000000000000000000000000000000000000001
10000000000000001000000000010000000000000000100000000001
10000001000000000000000100000000000000000000000000000001
10000000000010000000000000000100000000000000000000000001
10000000000000000000000000000000000001000000000000000001
10000000000000000000000000000000000000000000000000000001
 111111111111111111111111111111111111111111111111111111
