
NO ./textures/wolfenstein/blue_stone.xpm
SO ./textures/wolfenstein/grey_stone.xpm
WE ./textures/wolfenstein/mossy.xpm
EA ./textures/wolfenstein/color_stone.xpm
F 84,59,14
C 135,206,235
    1111111111
    10S000001
    1001111011
    1100000001
    11000000001
    110001000001
    100000000001
    11111011101
         1   1