1111111111111111111111
1000000000000000000001
1000000000000000000001
1000000000000000000001
1000000000000000000001
1000100000000000000001
1000100000000000000001
1000100000000000000001
1011100000010000000001
1000000000010000000001
1000000001010100000001
1000000001010100000001
1000000011111110000001
1000000001010100000001
1000000001010100000001
1000000000010000000001
1000000000010000000001
1000000000002000000001
1000000000000000000001
1000000000000000000001
1000111111111111110001
1000000000000000000001
1000000000000000000001
1000000000000000000001
1111111111111111111111